if=MINDAUGASL\if.tpl
ife=MINDAUGASL\if_else.tpl
%T=MINDAUGASL\%TYPE.tpl
sel=DML statements\Select.tpl
pl=MINDAUGASL\put_line(pl).tpl
var=MINDAUGASL\varchar2(var).tpl
varm=MINDAUGASL\varchar2max(varm).tpl
priv=Comments\Privalomas.tpl
nvl2=MINDAUGASL\nvl2.tpl
nimpl=MINDAUGASL\not_implemented.tpl
'=MINDAUGASL\double_quotes(').tpl
bug=Comments\Bug.tpl
dual=MINDAUGASL\dual.tpl
with=MINDAUGASL\with.tpl
like=MINDAUGASL\like.tpl
record=PLSQL Types\Record(record).tpl
dummy=MINDAUGASL\l_dummy.tpl
dmask=MINDAUGASL\date_mask(dmask).tpl
rap=MINDAUGASL\raise_application_error(rap).tpl
openc=MINDAUGASL\open.tpl
declare=MINDAUGASL\declare.tpl
//=Comments\comments_block
fori=Loops\Integer for loop.tpl
forrec=Loops\Implicit cursor loop.tpl
group=MINDAUGASL\group by.tpl
tpl=MINDAUGASL\testing.put_line(tpl).tpl
isnn=MINDAUGASL\is not null(isnn).tpl
truncate=MINDAUGASL\truncate.tpl
i++=MINDAUGASL\i++.tpl
count=MINDAUGASL\count.tpl
today=MINDAUGASL\today.tpl
wh=MINDAUGASL\where(wh).tpl
isn=MINDAUGASL\is null(isn).tpl
''=MINDAUGASL\string_quotes('').tpl
in=MINDAUGASL\in.tpl
extract=MINDAUGASL\extract.tpl
inner=MINDAUGASL\inner.tpl
case=MINDAUGASL\case.tpl
when=MINDAUGASL\when.tpl
delete=MINDAUGASL\delete.tpl
edited=Comments\Edited.tpl
to_date=MINDAUGASL\to_date.tpl
trim=MINDAUGASL\trim.tpl
upper=MINDAUGASL\upper.tpl
update=DML statements\Update.tpl
debug=MINDAUGASL\DEBUG\debug.tpl
scount=MINDAUGASL\select count.tpl